XXMXXXXXXXXXXXX
X   XX    XX  X
X     X       X
X     XXX     X
X  X    XXXX  X
X  X          X
X     X       X
X     X  X  XXX
X  XXXXXXX    X
X        X    X
X        XXX  X
X  X  X  X    X
X  X  X       X
X  X  X       X
XXXXOXXXXXXXXXX
