M#XXX#X#X#XXX###
########X#X###X#
X#XX#X#XX###X#X#
X#X##X####XXX###
####XX#X########
XXX####X#XX#XXX#
####XX#X##X#X###
##X#######X#####
X#X#XXX#X#XXX###
X#X#X###X#####X#
##X###X#XXXX##X#
####XXX#X#####X#
#X########XXX###
XXX#X#XXX###X###
####X##O##X###X#
################
